Searching for 'xspeed'...
Move_Character at line 11: 	Move_Character_Town(x,y-(global.Tile_Size),"Up",_tiles,_speed/global.xspeed,_animation_speed,_looking,_ignore_stairs);
Move_Character at line 16: 	Move_Character_Town(x,y+(global.Tile_Size),"Down",_tiles,_speed/global.xspeed,_animation_speed,_looking,_ignore_stairs);
Move_Character at line 21: 	Move_Character_Town(x-global.Tile_Size,y,"Left",_tiles,_speed/global.xspeed,_animation_speed,_looking,_ignore_stairs);
Move_Character at line 26: 	Move_Character_Town(x+global.Tile_Size,y,"Right",_tiles,_speed/global.xspeed,_animation_speed,_looking,_ignore_stairs);
obj_Dialogue_Controller-Step at line 35: 	alarm[0] = 1 * global.xspeed;
obj_Dialogue_Controller-Step at line 64: 	arrow_timer = 20 * global.xspeed;
obj_Dialogue_Controller-Step at line 68: 	arrow_timer = 20 * global.xspeed;
obj_Dialogue_Controller-Step at line 158: 	print_delay = 30 * global.xspeed;
obj_Dialogue_Controller-Step at line 257: 	case 1: print_delay = 6 * global.xspeed; break;
obj_Dialogue_Controller-Step at line 258: 	case 2: print_delay = 5 * global.xspeed; break;
obj_Dialogue_Controller-Step at line 259: 	case 3: print_delay = 4 * global.xspeed; break;
obj_Dialogue_Controller-Step at line 260: 	case 4: print_delay = 3 * global.xspeed; break;
obj_Dialogue_Controller-Step at line 261: 	case 5: print_delay = 2 * global.xspeed; break;
obj_Dialogue_Controller-Step at line 262: 	case 6: print_delay = 1 * global.xspeed; break;
obj_Dialogue_Controller-Step at line 263: 	default: print_delay = 1 * global.xspeed; break;
obj_Character-Create at line 34: 	max_ai_timer = 18 * global.xspeed;
obj_Character-Create at line 55: 	pathfinding_speed = 2 / global.xspeed;//speed when moving on a path
obj_Character-Create at line 291: 	event_cooldown = 60 * global.xspeed;//time between movement events
obj_Character-Create at line 326: 	idle_animation_speed = .0625 / global.xspeed;//animation speed for standing still
obj_Character-Create at line 327: 	player_walking_animation_speed = .125 / global.xspeed;//animation speed for moving
obj_Character-Create at line 328: 	npc_walking_animation_speed = .0625 / global.xspeed;//animation speed for moving
obj_Character-Create at line 329: 	player_move_speed = 2 / global.xspeed;//walk speed when the player moves them
obj_Character-Create at line 330: 	npc_move_speed = 1 / global.xspeed;//walk speed when an NPC moves by itself
Battle_Prop_Properties_SF2_Explosion_Large at line 3: 	var _animation_speed = .25 / global.xspeed;
obj_Waterfall-Create at line 1: 	image_speed = .125 / global.xspeed;
obj_Water_Wheel-Create at line 1: 	image_speed = .125 / global.xspeed;
obj_Windmill-Create at line 2: 	rotation_speed = 1 / global.xspeed;
obj_Cursor-Create at line 9: 	cursor_move_speed = 4 / global.xspeed;
obj_Cursor-Create at line 18: 	pathfinding_speed = 6 / global.xspeed;//speed when moving on a path
obj_Battle_Cutscene_Character-Create at line 12: 	x_pan_speed = 15 / global.xspeed;
obj_Battle_Cutscene_Character-Create at line 54: 	fade_speed = .1 / global.xspeed;
Battle_Prop_Properties_SF2_Blast_Slice at line 3: 	var _animation_speed = .25 / global.xspeed;
obj_Battle_Cutscene_Controller-Create at line 89: 	x_pan_speed = 35 / global.xspeed;
obj_Torch-Create at line 20: 	image_speed = .125 / global.xspeed;
Character_Properties_AU_Alpha_Wolf at line 44: 	var _animation_speed = .125 / global.xspeed; //Animation Speed
Battle_Prop_Properties_SF2_Blast_Tornado_Dust at line 3: 	var _animation_speed = .2 / global.xspeed;
Projectile_Properties_Battered_Arrow at line 4: 	var _movement_speed = 15 / global.xspeed;
Battle_Prop_Properties_AU_Heal_Green_Dust at line 3: 	var _animation_speed = .34 / global.xspeed;
Battle_Prop_Properties_SF2_Blaze_Fire_Medium at line 3: 	var _animation_speed = .2 / global.xspeed;
Battle_Prop_Properties_AU_Detox_Green_Charge at line 3: 	var _animation_speed = .5 / global.xspeed;
Character_Properties_Generic_Debug_Enemy at line 45: 	var _animation_speed = .0625 / global.xspeed; //Animation Speed
Battle_Prop_Properties_AU_Detox_Purple_Upstream at line 3: 	var _animation_speed = .5 / global.xspeed;
Battle_Prop_Properties_AU_Blast_Whirlwind_04_Following at line 3: 	var _animation_speed = .5 / global.xspeed;
obj_Land_Effect_Window-Create at line 14: 	pan_speed = 8 / global.xspeed;
obj_Battle_HUD-Create at line 17: 	pan_speed = 8 / global.xspeed;
obj_Minimap_Controller-Create at line 8: 	pan_speed = (max_pan / (12 * global.xspeed));
obj_Minimap_Controller-Create at line 14: 	max_flash_time = 15 * global.xspeed;;
obj_Item_Selection_Controller-Create at line 45: 	animation_speed = .0625 * global.xspeed;;
obj_Item_Selection_Controller-Create at line 50: 	pan_speed_up = (max_y_pan / (8 * global.xspeed));//pan speed up
obj_Item_Selection_Controller-Create at line 51: 	pan_speed_down = (max_y_pan / (8 * global.xspeed));//pan speed down
obj_Item_Selection_Controller-Create at line 52: 	pan_speed_left = (max_x_pan / (8 * global.xspeed));//25;//pan speed left
obj_Item_Selection_Controller-Create at line 53: 	pan_speed_right = (max_x_pan / (8 * global.xspeed));//25;//pan speed right
obj_Item_Selection_Controller-Create at line 54: 	equip_pan_speed = (max_equip_pan_x / (8 * global.xspeed));
obj_Spell_Selection_Controller-Create at line 37: 	animation_speed = .0625 / global.xspeed;
obj_Spell_Selection_Controller-Create at line 48: 	pan_speed_up = (max_y_pan / (8 * global.xspeed));//pan speed up
obj_Spell_Selection_Controller-Create at line 49: 	pan_speed_down = (max_y_pan / (8 * global.xspeed));//pan speed down
obj_Spell_Selection_Controller-Create at line 50: 	pan_speed_left = (max_x_pan / (8 * global.xspeed));//25;//pan speed left
obj_Spell_Selection_Controller-Create at line 51: 	pan_speed_right = (max_x_pan / (8 * global.xspeed));//25;//pan speed right
obj_Target_Tile-Create at line 1: 	image_speed = .125 / global.xspeed;
obj_Movement_Tile-Create at line 1: 	image_speed = .125 / global.xspeed;
obj_Cross_Menu-Create at line 22: 	max_input_delay = 40 * global.xspeed;//on key press, set timer to 40
obj_Cross_Menu-Create at line 23: 	min_input_delay = 5 * global.xspeed;//on continued hold, set timer to 5
obj_Cross_Menu-Create at line 36: 	animation_speed = .0625 / global.xspeed;
obj_Cross_Menu-Create at line 44: 	pan_speed_up = (max_y_pan / (8 * global.xspeed));//25;//pan speed up
obj_Cross_Menu-Create at line 45: 	pan_speed_down = (max_y_pan / (8 * global.xspeed));//18;//pan speed down
obj_Cross_Menu-Create at line 46: 	pan_speed_left = (max_x_pan / (8 * global.xspeed));//25;//pan speed left
obj_Cross_Menu-Create at line 47: 	pan_speed_right = (max_x_pan / (8 * global.xspeed));//25;//pan speed right
obj_Church_Controller-Create at line 28: 	pan_speed = 8 * global.xspeed;
obj_Shop_Controller-Create at line 17: 	max_input_delay = 40 * global.xspeed;//on key press, set timer to 40
obj_Shop_Controller-Create at line 18: 	min_input_delay = 5 * global.xspeed;//on continued hold, set timer to 5
obj_Shop_Controller-Create at line 28: 	arrow_flash_speed = 10 * global.xspeed;
obj_Shop_Controller-Create at line 32: 	cursor_flash_speed = 10 * global.xspeed;
obj_Shop_Controller-Create at line 56: 	pan_speed = 8 * global.xspeed;
obj_Decision_Controller-Create at line 18: 	max_input_delay = 40 * global.xspeed;//on key press, set timer to 40
obj_Decision_Controller-Create at line 19: 	min_input_delay = 5 * global.xspeed;//on continued hold, set timer to 5
obj_Decision_Controller-Create at line 28: 	image_speed = .0625 / global.xspeed;//speed of animation
obj_Decision_Controller-Create at line 32: 	pan_speed = 8 * global.xspeed;//pan speed
obj_Status_Page_Controller-Create at line 29: 	pan_speed = 8 * global.xspeed;
obj_Member_List_Controller-Create at line 4: 	image_speed = .0625 / global.xspeed;
obj_Member_List_Controller-Create at line 43: 	max_input_delay = 40 * global.xspeed;//on key press, set timer to 40
obj_Member_List_Controller-Create at line 44: 	min_input_delay = 5 * global.xspeed;//on continued hold, set timer to 5
obj_Member_List_Controller-Create at line 77: 	pan_speed = 8 * global.xspeed;
obj_Name_Character_Controller-Step at line 51: 	cursor_flash_timer = 15 * global.xspeed;//reset flash time
obj_Name_Character_Controller-Step at line 55: 	cursor_flash_timer = 15 * global.xspeed;//reset flash time
obj_Name_Character_Controller-Create at line 7: 	cursor_flash_timer = 15 * global.xspeed;//Time between arrow flashes
obj_Name_Character_Controller-Create at line 22: 	max_input_delay = 40 * global.xspeed;//on key press, set timer to 40
obj_Name_Character_Controller-Create at line 23: 	min_input_delay = 5 * global.xspeed;//on continued hold, set timer to 5
obj_Name_Character_Controller-Create at line 86: 	pan_speed = 8 * global.xspeed;
Battle_Prop_Properties_AU_Heal_Light_Gold at line 3: 	var _animation_speed = .34 / global.xspeed;
obj_Save_Slots_Controller-Step at line 38: 	scroll_arrow_timer -= 1 / global.xspeed;
obj_Save_Slots_Controller-Create at line 13: 	max_scroll_arrow_timer = 15 * global.xspeed;//Time between arrow flashes
obj_Save_Slots_Controller-Create at line 21: 	max_input_delay = 40 * global.xspeed;//on key press, set timer to 40
obj_Save_Slots_Controller-Create at line 22: 	min_input_delay = 5 * global.xspeed;//on continued hold, set timer to 5
obj_Save_Slots_Controller-Create at line 42: 	pan_speed = 8 * global.xspeed;
obj_Start_Menu_Controller-Step at line 38: 	scroll_arrow_timer -= 1 / global.xspeed;
obj_Start_Menu_Controller-Create at line 13: 	max_scroll_arrow_timer = 15 * global.xspeed;//Time between arrow flashes
obj_Start_Menu_Controller-Create at line 21: 	max_input_delay = 40 * global.xspeed;//on key press, set timer to 40
obj_Start_Menu_Controller-Create at line 22: 	min_input_delay = 5 * global.xspeed;//on continued hold, set timer to 5
obj_Start_Menu_Controller-Create at line 46: 	pan_speed = 8 * global.xspeed;
obj_Options_Menu-Step at line 38: 	scroll_arrow_timer -= 1 / global.xspeed;
obj_Options_Menu-Create at line 7: 	scroll_arrow_timer = 15 * global.xspeed;//Time between arrow flashes
obj_Options_Menu-Create at line 27: 	max_input_delay = 40 * global.xspeed;//on key press, set timer to 40
obj_Options_Menu-Create at line 28: 	min_input_delay = 5 * global.xspeed;//on continued hold, set timer to 5
obj_Options_Menu-Create at line 41: 	pan_speed = 8 * global.xspeed;
obj_Screen_Flash_Controller-Create at line 3: 	flash_speed = .02 / global.xspeed;//speed of the fade
obj_Portrait_Controller-Create at line 10: 	talk_speed_modifier = .08 * global.xspeed;//multiply this by speed to get animation speed
obj_Portrait_Controller-Create at line 14: 	blink_speed = 1 / global.xspeed;//blink animation speed
obj_Portrait_Controller-Create at line 15: 	blink_min = 20 * global.xspeed;//mimimum wait time between blinks
obj_Portrait_Controller-Create at line 16: 	blink_max = 180 * global.xspeed;//maximum wait time between blinks
obj_Portrait_Controller-Create at line 23: 	pan_speed = 8 * global.xspeed;
obj_Dialogue_Controller-Create at line 22: 	end_message_delay = 5 * global.xspeed*2;//default 'continue' delay.
obj_Dialogue_Controller-Create at line 45: 	pan_speed = 8 * global.xspeed;
Character_Properties_AU_Kira at line 58: 	var _animation_speed = .0625 / global.xspeed; //Animation Speed
Battle_Prop_Properties_AU_Detox_Purple_Circle_Spark at line 3: 	var _animation_speed = .5 / global.xspeed;
Create_Global_Game_Settings at line 53: 	global.xspeed = global.FPS_Cap/60;
Create_Global_Game_Settings at line 56: 	global.xspeed = ceil(display_get_frequency())/60}
Battle_Prop_Properties_AU_Heal_Thread_Green at line 3: 	var _animation_speed = .5 / global.xspeed;
Character_Properties_Default at line 37: 	var _animation_speed = .0625 / global.xspeed;
Battle_Prop_Properties_AU_Heal_Targeting_Lights at line 3: 	var _animation_speed = .45 / global.xspeed;
Battle_Prop_Properties_AU_Blast_Lil_Dust at line 3: 	var _animation_speed = .5 / global.xspeed;
Battle_Prop_Properties_AU_Blaze_Fireburst_Huge at line 3: 	var _animation_speed = .5 / global.xspeed;
Battle_Prop_Properties_AU_Blaze_Fire_Light at line 3: 	var _animation_speed = .5 / global.xspeed;
Battle_Prop_Properties_SF2_Blaze_Explosion_Large at line 3: 	var _animation_speed = .25 / global.xspeed;
Battle_Prop_Properties_AU_Blaze_Fire_Slash at line 3: 	var _animation_speed = .5 / global.xspeed;
Battle_Prop_Properties_AU_Detox at line 3: 	var _animation_speed = .5 / global.xspeed;
Hillford_Inn_Cutscene at line 77: 	alarm[0] = 30 * global.xspeed;
Hillford_Inn_Cutscene at line 87: 	alarm[0] = 30 * global.xspeed;
Hillford_Inn_Cutscene at line 183: 	alarm[0] = 30 * global.xspeed;
Hillford_Inn_Cutscene at line 306: 	alarm[0] = 1 * global.xspeed;
Hillford_Inn_Cutscene at line 326: 	alarm[0] = 20 * global.xspeed;
Hillford_Inn_Cutscene at line 347: 	alarm[0] = 60 * global.xspeed;
Hillford_Inn_Cutscene at line 353: 	alarm[0] = 10 * global.xspeed;
Hillford_Inn_Cutscene at line 468: 	alarm[0] = 30 * global.xspeed;
Hillford_Inn_Cutscene at line 489: 	alarm[0] = 10 * global.xspeed;
Hillford_Inn_Cutscene at line 495: 	alarm[0] = 10 * global.xspeed;
Hillford_Inn_Cutscene at line 501: 	alarm[0] = 10 * global.xspeed;
Battle_Prop_Properties_AU_Blaze_Fireball_Small at line 3: 	var _animation_speed = .25 / global.xspeed;
Battle_Prop_Properties_AU_Blast_Whirlwind_03_Following at line 3: 	var _animation_speed = .5 / global.xspeed;
Battle_Prop_Properties_SF2_Blast_Slash_1 at line 3: 	var _animation_speed = .2 / global.xspeed;
Character_Properties_AU_Wisp at line 46: 	var _animation_speed = .0625 / global.xspeed; //Animation Speed
Meeting_Max_Cutscene at line 57: 	alarm[0] = 20 * global.xspeed;
Meeting_Max_Cutscene at line 78: 	alarm[0] = 20 * global.xspeed;
Meeting_Max_Cutscene at line 100: 	alarm[0] = 20 * global.xspeed;
Battle_Prop_Properties_AU_Blaze_Fire_Pillar_Small at line 3: 	var _animation_speed = .5 / global.xspeed;
Battle_Prop_Properties_SF2_Blast_Slash_Small_1 at line 3: 	var _animation_speed = .2 / global.xspeed;
Battle_Prop_Properties_AU_Blaze_BG_Fire at line 3: 	var _animation_speed = .5 / global.xspeed;
Battle_Prop_Properties_AU_Blast_BG_Wind at line 3: 	var _animation_speed = .5 / global.xspeed;
Chained_Animation at line 7: 	Sprite_Animation(_character,spr_Explode_Overworld,1,.125 / global.xspeed,true,true);
Chained_Animation at line 19: 	Sprite_Animation(_character,spr_Magic_Beam_Fade_Overworld,1,.25 / global.xspeed,true,true);
Chained_Animation at line 26: 	Sprite_Animation(_character,spr_Explode_Blue_Overworld,1,.125 / global.xspeed,true,true);
Perform_Jump at line 4: 	_character.animation_speed = _speed / global.xspeed;//set animation speed
Shake_Head at line 6: 	_character.animation_speed = _speed * global.xspeed;//animation speed
Nod_Head at line 5: 	_character.animation_speed = _speed * global.xspeed;
Fade_Character at line 4: 	_character.animation_speed = _speed / global.xspeed;//set draw speed
Spin at line 4: 	_character.animation_speed = _speed * global.xspeed;//speed of animation
Shudder at line 6: 	_character.animation_speed = 5 * global.xspeed;
Enable_Spell_Cast_Flash at line 19: 	_character.flash_speed = _speed * global.xspeed;
Battle_Prop_Properties_AU_Blast_Green_Wind_Explosion_Dark at line 3: 	var _animation_speed = .5 / global.xspeed;
Battle_Prop_Properties_AU_Blast_Whirlwind_Dark_02_Following at line 3: 	var _animation_speed = .5 / global.xspeed;
Move_Overworld_Projectile at line 5: 	movement_speed = _speed / global.xspeed;
Battle_Prop_Properties_AU_Blaze_Fire_Pillar_Large_Loop at line 3: 	var _animation_speed = .5 / global.xspeed;
Battle_Prop_Properties_AU_Blast_Wind_Spark at line 3: 	var _animation_speed = .5 / global.xspeed;
Battle_Prop_Properties_AU_Heal_Thread_Blue at line 3: 	var _animation_speed = .34 / global.xspeed;
Jasons_Room_Cutscene at line 7: 	alarm[0] = 120 * global.xspeed;
Jasons_Room_Cutscene at line 12: 	alarm[0] = 30 * global.xspeed;
Jasons_Room_Cutscene at line 17: 	alarm[0] = 30 * global.xspeed;
Jasons_Room_Cutscene at line 22: 	alarm[0] = 60 * global.xspeed;
Jasons_Room_Cutscene at line 30: 	alarm[0] = 30 * global.xspeed;
Jasons_Room_Cutscene at line 35: 	alarm[0] = 10 * global.xspeed;
Jasons_Room_Cutscene at line 40: 	alarm[0] = 10 * global.xspeed;
Jasons_Room_Cutscene at line 45: 	alarm[0] = 10 * global.xspeed;
Meeting_Max_Cutscene180 at line 11: 	alarm[0] = 20 * global.xspeed; // causes crash at 240fps, required for 60fps
Meeting_Max_Cutscene180 at line 21: 	alarm[0] = 20 * global.xspeed;
Meeting_Max_Cutscene180 at line 41: 	alarm[0] = 20 * global.xspeed;
Meeting_Max_Cutscene180 at line 62: 	alarm[0] = 20 * global.xspeed;
Meeting_Max_Cutscene180 at line 84: 	alarm[0] = 20 * global.xspeed;
Battle_Prop_Properties_AU_Freeze_Shard_Small at line 3: 	var _animation_speed = .25 / global.xspeed;
Create_Dialogue at line 9: 	_this.end_message_delay = _delay * global.xspeed;//delay until panning out dialogue (so the text isnt instantly removed)
Character_Properties_AU_Jason at line 60: 	var _animation_speed = .0625 / global.xspeed; //Animation Speed
Battle_Prop_Properties_AU_Detox_Green_Expand at line 3: 	var _animation_speed = .5 / global.xspeed;
Battle_Prop_Properties_SF2_Prism_Flower_Shot at line 3: 	var _animation_speed = .5 / global.xspeed;
Battle_Prop_Properties_AU_Blaze_Fireburst_Large at line 3: 	var _animation_speed = .5 / global.xspeed;
Battle_Prop_Properties_SF2_Blast_Tornado at line 3: 	var _animation_speed = .25 / global.xspeed;
Fade_Overworld_Projectile at line 5: 	fade_speed = _speed / global.xspeed;
Battle_Prop_Properties_AU_Blaze_Fire_Small at line 3: 	var _animation_speed = .25 / global.xspeed;
Character_Properties_AU_Training_Dummy at line 54: 	var _animation_speed = .125 / global.xspeed; //Animation Speed
Flash_Battle_Cutscene at line 7: 	obj_Battle_Cutscene_Controller.flash_timer = _time * global.xspeed;
Pan_Battle_Cutscene_Character at line 9: 	x_pan = max_x_pan * (global.xspeed/4);
Pan_Battle_Cutscene_Character at line 13: 	x_pan = -(max_x_pan*2) * (global.xspeed/4);
Play_Battle_Animation at line 19: 	Hit_Flash(_object,.125 / global.xspeed);
Play_Battle_Animation at line 20: 	_object.hit_timer = _object.max_hit_timer * global.xspeed;
Battle_Prop_Properties_AU_Detox_Green_Circle_Loop at line 3: 	var _animation_speed = .5 / global.xspeed;
Character_Properties_AU_Wolf at line 43: 	var _animation_speed = .125 / global.xspeed; //Animation Speed
Battle_Prop_Properties_AU_Blast_Quick_Wind at line 3: 	var _animation_speed = .5 / global.xspeed;
Battle_Prop_Properties_AU_Heal_Light_Blue at line 3: 	var _animation_speed = .34 / global.xspeed;
AU_Moorenfirch_Priest_Blacksmith at line 21: 	alarm[0] = 50 * global.xspeed;
AU_Moorenfirch_Priest_Blacksmith at line 28: 	alarm[0] = 30 * global.xspeed;
Battle_Prop_Properties_AU_Blaze_BG_Embers at line 3: 	var _animation_speed = .5 / global.xspeed;
Battle_Prop_Properties_AU_Heal_Spark at line 3: 	var _animation_speed = .34 / global.xspeed;
Character_Properties_AU_Max at line 73: 	var _animation_speed = .0625 / global.xspeed; //Animation Speed
Battle_Prop_Properties_AU_Heal_Spark_Gold at line 3: 	var _animation_speed = .34 / global.xspeed;
Battle_Prop_Properties_AU_Detox_Purple_Circle at line 3: 	var _animation_speed = .5 / global.xspeed;
Battle_Prop_Properties_AU_Blaze_Fire_Pillar_Large_End at line 3: 	var _animation_speed = .5 / global.xspeed;
Battle_Prop_Properties_SF2_Blast_Slash_Small_2 at line 3: 	var _animation_speed = .2 / global.xspeed;
Continue_Screen_Fade at line 6: 	fade_speed = _speed / global.xspeed;
Create_Screen_Shake at line 6: 	shake_timer = _timer * global.xspeed;//length of screen shake (-1 for infinite)
Create_Screen_Fade at line 9: 	fade_speed = _speed / global.xspeed;
Pan_Camera_To_Target at line 5: 	camera_speed = _speed / global.xspeed;
Pan_Camera_To_Location at line 8: 	camera_speed = _speed / global.xspeed;
Battle_Prop_Properties_SF2_Blaze_Fire_Large at line 3: 	var _animation_speed = .2 / global.xspeed;
Character_Properties_AU_Ciera at line 65: 	var _animation_speed = .0625 / global.xspeed; //Animation Speed
obj_Overworld_Projectile-Create at line 6: 	movement_speed = 1 / global.xspeed;//how fast the projectile moves
obj_Overworld_Brawl-Create at line 1: 	image_speed = .125 / global.xspeed;
Battle_Prop_Properties_AU_Blast_Whirlwind_02_Following at line 3: 	var _animation_speed = .5 / global.xspeed;
Battle_Prop_Properties_AU_Heal_OLD at line 3: 	var _animation_speed = .5 / global.xspeed;
Battle_Prop_Properties_AU_Blast_Whirlwind_Dark at line 3: 	var _animation_speed = .5 / global.xspeed;
Character_Properties_AU_Phillip at line 62: 	var _animation_speed = .0625 / global.xspeed; //Animation Speed
Character_Properties_SF2_Burst_Rock at line 52: 	var _animation_speed = .125 / global.xspeed; //Animation Speed
Battle_Prop_Properties_AU_Detox_Green_Circle_Intro at line 3: 	var _animation_speed = .5 / global.xspeed;
obj_Splash_Screen_Controller-Create at line 7: 	image_speed = .17 / global.xspeed;
obj_Splash_Screen_Controller-Create at line 12: 	fade_speed = .05 / global.xspeed;
Create_Screen_Flash at line 8: 	flash_speed = _speed / global.xspeed;
AU_Moorenfirch_Priest_Church at line 20: 	if (global.FPS_Cap <= 180) {alarm[0] = 2 * global.xspeed;}
AU_Moorenfirch_Priest_Church at line 21: 	else {alarm[0] = 40 * global.xspeed;}
AU_Moorenfirch_Priest_Church at line 26: 	alarm[0] = 20 * global.xspeed;
AU_Moorenfirch_Priest_Church at line 33: 	alarm[0] = 30 * global.xspeed;
Battle_Prop_Properties_AU_Blaze_Fire_Light_Foreground at line 3: 	var _animation_speed = .5 / global.xspeed;
Battle_Prop_Properties_SF2_Blaze_Explosion_Small at line 3: 	var _animation_speed = .25 / global.xspeed;
Battle_Prop_Properties_AU_Blaze_Fire_Pillar_Large_Start at line 3: 	var _animation_speed = .5 / global.xspeed;
Character_Properties_AU_Karina at line 61: 	var _animation_speed = .0625 / global.xspeed; //Animation Speed
Battle_Prop_Properties_AU_Blaze_Fireburst_Small at line 3: 	var _animation_speed = .5 / global.xspeed;
Battle_Prop_Properties_SF2_Blast_Slash_2 at line 3: 	var _animation_speed = .2 / global.xspeed;
Battle_Prop_Properties_SF2_Blaze_Fire_Small at line 3: 	var _animation_speed = .2 / global.xspeed;//How fast it animates
Battle_Prop_Properties_AU_Blast_Whirlwind_05_Following at line 3: 	var _animation_speed = .5 / global.xspeed;
Battle_Prop_Properties_AU_Detox_Thread_Purple at line 3: 	var _animation_speed = .5 / global.xspeed;
Battle_Prop_Properties_AU_Detox_Green_Circle_End at line 3: 	var _animation_speed = .5 / global.xspeed;
Character_Properties_AU_Stalagnid at line 39: 	var _animation_speed = .0625 / global.xspeed; //Animation Speed
Character_Properties_SF2_Prism_Flower at line 46: 	var _animation_speed = .125 / global.xspeed; //Animation Speed
Battle_Prop_Properties_AU_Heal_Spark_Gold_Full at line 3: 	var _animation_speed = .34 / global.xspeed;
Battle_Prop_Properties_AU_Blast_Whirlwind_01 at line 3: 	var _animation_speed = .5 / global.xspeed;
Battle_Prop_Properties_AU_Blast_Green_Wind_Explosion at line 3: 	var _animation_speed = .5 / global.xspeed;
Search Complete (241 results)